11111111111111111111111111111111
1X1WWW1GGG1GGG1WW11111111111WWW1
1GGGGGGG1GGG1GGGGGGGGGGGGGG1WWW1
11G111111111111111G1111111G1WWW1
11G111111111111111GGGG1GGGGGGG11
1GGGGGGGGGG1GGG111111111111G1G11
1G11111111G1G1GGGGGGGGGGGG1G1GW1
1G11111111GGG111111111111G1G1GW1
1GG1G1G1G1GG1111111GGGGGGGGG1GW1
1GGGGGGGGGGG1G1GGG1G1111111GGGW1
1G111111111G111G1G1111KGGGGGG111
1G11111GGGGG1GGG1G1G11GGGGGGG1G1
1G1GGG1G11G11G111G1G11G1111111G1
1GGG1G1G11G1GGG1GG1GGGG1GGGGGGG1
11111G1G1GG1GGGGG11111111111G111
1GGK1G1G1G11G111111111WWW1GGG111
1GG11G1G1GGGG1WWW111111G11G11111
1G1111111G1111GGGGGGGGGGG1G11111
1G1WW1111GGGGGGGGGGGGGGGGGG111W1
1G11G111111111G11111111G11D1WWW1
1GGGGGGGGGGGG1G1111GGGGG1GGGG111
11G111111G1111G1WW1GGGGG1GGGFW11
1WO1GGGGGGGGGGGGGGGGGGGG11111111
11111111111111111111111111111111