11111111111111111111111111111111
1X1WWW1...1...1WW11111111111WWW1
1.......1...1.........111111WWW1
11..11111111111111.111.11111WWW1
11.111111111111111............11
1..........1...111111111111.1.11
1.11111111.1.1............1.1.W1
1.11111111...111111111111.1.1..1
1...1.1.1.1.1.....1.......1....1
1.1...............1.1111111....1
1.11111111........1.11.......111
1.11111...........1.11.......1.1
1.1...1.11........1.1111111111.1
1...1.1.11....WWW..............1
11111.1.1.....WWW11111111111.111
1...1.1.1111.111111111WOW1...111
1..11.1.1.........O1111.11.11111
1.1111111................1.11111
1.1WW1111..................111W1
1.11.111111111.11111111.11.1WWW1
1............1.1111.....1....111
11.111111.1111.1WW1.....1...GW11
1WO1....................11111111
11111111111111111111111111111111