11111111111111111111111111111111
1X1WWW1...1...1WW11111111111WWW1
1.......1...1..............1WWW1
11.111111111111111.1111111.1WWW1
11.111111111111111....1.......11
1..........1...111111111111.1.11
1.11111111.1.1............1.1.W1
1.11111111...111111111111.1.1.W1
1..1.1.1.1..1111111.........1.W1
1...........1.1...1.1111111...W1
1.111111111.111.1.1111K......111
1.11111.....1...1.1.11.......1.1
1.1...1.11.11.111.1.11.1111111.1
1...1.1.11.1...1..1....1.......1
11111.1.1..1.....11111111111.111
1..K1.1.1.11.111111111WWW1...111
1..11.1.1....1WWW111111.11.11111
1.1111111.1111...........1.11111
1.1WW1111..................111W1
1.11.111111111.11111111.11D1WWW1
1............1.1111.....1....111
11.111111.1111.1WW1.....1...GW11
1WO1....................11111111
11111111111111111111111111111111